abair	a bˠ ə ɾʲ
ábalta	ˈ aː bˠ ə l̻ˠ t̪ˠ ə
ab	a bˠ
abhaile	ə ˈ vˠ a lʲ ə
ach	ˈ a h
acu	ˈ a k uː
adúbradh	 a d̪ˠ uː bˠ ɾˠ uː
a	ə
agaibh	ˈ ə ɡ ə vʲ
againn	ˈ ə ɡ ə n̻ʲ
agam	ˈ ə ɡ ə mˠ
agat	ˈ ə ɡ ə t̪ˠ
ag	ˈ e ɟ
aghaidh	ˈ eː j
agus	ˈ ə ɡ ə sˠ
aici	ˈ e c iː
aicme	ˈ a c mʲ ə
aidhm	ˈ eː mʲ
aige	ˈ e ɟ ə
aighneas	ˈ ai nʲ ə sˠ
aighnis	 ai nʲ i ʃ
aigne	ˈ a ɟ nʲ ə
áil	ˈ aː lʲ
áilleacht	ˈ aː l̻ʲ a x t̪ˠ
aimsir	ˈ a mʲ ʃ ə ɾʲ
aimsire	ˈ a mʲ ʃ ə ɾʲ ə
aingeal	ˈ a ɲ ɟ ə l̻ˠ
airc	ˈ a ɾʲ c
air	ˈ e ɾʲ
airgead	ˈ a ɾʲ ə ɟ ə d̪ˠ
airigh	ˈ a ɾʲ iː
airighdís	 a ɾʲ iː dʲ iː ʃ
ais	ˈ a ʃ
aisti	ˈ a ʃ tʲ iː
ait	ˈ a tʲ
áit	ˈ aː tʲ
aitean	 a tʲ ə n̻ˠ
aithne	ˈ ai hʲ nʲ ə
allta	ˈ o l̻ˠ t̪ˠ ə
alltacht	ˈ o l̻ˠ t̪ˠ a x t̪ˠ
amach	ə ˈ mˠ a h
amháin	ə ˈ vˠ aː nʲ
amhlaidh	ˈ au l̻ˠ iː
amhras	ˈ au ɾˠ ə sˠ
amú	ə ˈ mˠ uː
ana	 a n̻ˠ ə
anacair	ˈ a n̻ˠ ə k ə ɾʲ
anall	ə ˈ n̻ˠ aː l̻ˠ
anama	 a n̻ˠ ə mˠ ə
anam	ˈ a n̻ˠ ə mˠ
an	ˈ ə n̻ˠ
an-bheag	 a n̻ˠ vʲ a ɡ
an-mhór	 a n̻ˠ vˠ oː ɾˠ
an-mhaith	 a n̻ˠ vˠ ai ç
aníos	ə ˈ nʲ iː sˠ
ann	ˈ ə n̻ˠ
anois	ə ˈ n̻ˠ i ʃ
anonn	ə ˈ n̻ˠ o n̻ˠ
anuas	ə ˈ n̻ˠ ua sˠ
aon	ˈ eː n̻ˠ
aos	ˈ iː sˠ
ár	ˈ aː ɾˠ
aráin	ˈ a ɾˠ a nʲ
arán	ˈ a ɾˠ a n̻ˠ
araon	ˈ ə ɾˠ i n̻ˠ
arbhair	 a ɾˠ ə vˠ ə ɾʲ
ar	ˈ e ɾʲ
arm	ˈ a ɾˠ ə mˠ
armáil	ˈ a ɾˠ ə mˠ a lʲ
arsa	ˈ e ɾˠ sˠ ə
arsan	 a ɾˠ sˠ ə n̻ˠ
as	ˈ a sˠ
atá	ə ˈ t̪ˠ aː
atáim	 a t̪ˠ a mʲ
athair	ˈ a h ə ɾʲ
athar	 a h ə ɾˠ
áthas	ˈ aː h ə sˠ
ath-léighte	 a h lʲ eː j tʲ ə
ba	ˈ bˠ ə
bac	ˈ bˠ a k
baclainn	ˈ bˠ a k l̻ˠ ə n̻ʲ
bácús	ˈ bˠ aː k u sˠ
baile	ˈ bˠ a lʲ ə
baineadh	ˈ bˠ a n̻ʲ uː
báine	ˈ bˠ aː nʲ ə
bainne	ˈ bˠ a n̻ʲ ə
baint	ˈ bˠ a nʲ tʲ
bainte	 bˠ a nʲ tʲ ə
báis	 bˠ aː ʃ
balcais	ˈ bˠ o l̻ˠ k ə ʃ
ball	ˈ bˠ aː l̻ˠ
bamhlaidh	 bˠ au l̻ˠ iː
bána	 bˠ aː n̻ˠ ə
ban	ˈ bˠ a n̻ˠ
bán	ˈ bˠ aː n̻ˠ
bar	 bˠ a ɾˠ
bás	ˈ bˠ aː sˠ
bata	ˈ bˠ a t̪ˠ ə
beaga	ˈ bʲ o ɡ ə
beagáinín	 bʲ i ɡ aː nʲ iː nʲ
beagán	ˈ bʲ o ɡ a n̻ˠ
beag	ˈ bʲ o ɡ
béal	ˈ bʲ eː l̻ˠ
bean	ˈ bʲ a n̻ˠ
beannacht	ˈ bʲ a n̻ˠ a x t̪ˠ
beann	ˈ bʲ a n̻ˠ
bearna	ˈ bʲ aː ɾˠ n̻ˠ ə
bearnach	ˈ bʲ aː ɾˠ n̻ˠ a h
beatha	ˈ bʲ a h ə
bé	ˈ bʲ eː
beidh	ˈ bʲ eː j
beidh(	 bʲ eː
béigean	ˈ bʲ eː ɟ ə n̻ˠ
béil	 bʲ eː lʲ
béile	ˈ bʲ eː lʲ ə
beirt	ˈ bʲ e ɾʲ tʲ
beo	ˈ bʲ oː
bfhearr	ˈ bʲ aː ɾˠ
bfhéidir	ˈ bʲ eː dʲ i ɾʲ
bhácáil	 vˠ aː k a lʲ
bhácúis	 vˠ aː k u ʃ
bhaile	ˈ vˠ a lʲ ə
bhail	ˈ vˠ a lʲ
bhainfeadh	ˈ vˠ i n̻ʲ uː
bhaint	ˈ vˠ a nʲ tʲ
bhairille	 vˠ a ɾʲ i l̻ʲ ə
bháis	ˈ vˠ aː ʃ
bhall	 vˠ o l̻ˠ
bhán	ˈ vˠ aː n̻ˠ
bharántas	 vˠ a ɾˠ aː n̻ˠ t̪ˠ ə sˠ
bhara	 vˠ a ɾˠ ə
bharúntacht	 vˠ a ɾˠ uː n̻ˠ t̪ˠ a ɾˠ t̪ˠ
bhata	 vˠ a t̪ˠ ə
bheagán	ˈ vʲ o ɡ a n̻ˠ
bheag	ˈ vʲ o ɡ
bhéal	ˈ vʲ eː l̻ˠ
bhean	ˈ vʲ a n̻ˠ
bhéarfadh	ˈ vʲ eː ɾˠ h uː
bhearna	 vʲ a ɾˠ n̻ˠ ə
bheatha	ˈ vʲ a h ə
bhéiceas	 vʲ eː c ə sˠ
bheidh	ˈ vʲ eː j
bheidh(	 vʲ eː
bheidís	 vʲ e dʲ iː ʃ
bheifeá	ˈ vʲ e fʲ aː
bheinn	ˈ vʲ eː n̻ʲ
bheirt	ˈ vʲ e ɾˠ tʲ
bheith	ˈ vʲ e hʲ
bhfágadh	 vˠ aː ɡ uː
bhfanaidís	 vˠ a n̻ˠ ə dʲ iː ʃ
bhfanfadh	 vˠ a n̻̊ˠ uː
bhfeabhas	 vʲ oː sˠ
bhfeaca	 vʲ a k ə
bhféadfadh	 vʲ eː t̪ˠ uː
bhféadfaidís	 vʲ eː t̪ˠ ə dʲ iː ʃ
bhféadfaí	 vʲ eː d̪ˠ fˠ iː
bhfear	 vʲ a ɾˠ
bhfeiceadh	 vʲ e c uː
bhfeicfeadh	 vʲ e c uː
bhfeicinn	 vʲ e c i n̻ʲ
bhfeidhm	 vʲ eː mʲ
bhfeirimitíbh	 vʲ e ɾʲ i mʲ i tʲ iː vʲ
bhfeirm	 vʲ e ɾʲ ə mʲ
bhfiacala	 vʲ ia k ə l̻ˠ ə
bhfichidí	 vʲ i hʲ i dʲ iː
bhfocal	 vˠ o k ə l̻ˠ
bhfochair	 vˠ o h ə ɾʲ
bhformhór	 vˠ a ɾˠ ə vˠ o ɾˠ
bhfuair	ˈ vˠ uː ɾʲ
bhfuil	ˈ vˠ i lʲ
bhfuinneamh	 vˠ i n̻ʲ uː
bhídís	 vʲ iː dʲ iː ʃ
bhig	ˈ vʲ i ɟ
bhinn	ˈ vʲ i n̻ʲ
bhínn	ˈ vʲ iː n̻ʲ
bhíodar	 vʲ iː d̪ˠ ə ɾˠ
bhíodh	ˈ vʲ iː uː
bhí	ˈ vʲ iː
bhlasta	 vˠ l̻ˠ a sˠ t̪ˠ ə
bhláth	 vˠ l̻ˠ aː h
bhliain	ˈ vˠ lʲ ia nʲ
bhlúire	 vˠ l̻ˠ uː ɾʲ ə
bhotháin	 vˠ a h a nʲ
bhóthair	 vˠ oː h ə ɾʲ
bhóthar	 vˠ oː h ə ɾˠ
bhó	ˈ vˠ oː
bhraiceal	 vˠ ɾˠ a c ə l̻ˠ
bhrath	 vˠ ɾˠ a h
bhreith	 vʲ ɾʲ ai ç
bhriseadh	 vʲ ɾʲ i ʃ uː
bhriste	ˈ vʲ ɾʲ i ʃ tʲ ə
bhrollach	 vˠ ɾˠ a l̻ˠ a h
bhuachaill	ˈ vˠ u h i l̻ʲ
bhuadhdar	 vˠ ua ɣ d̪ˠ ə ɾˠ
bhuaileadh	 vˠ ua lʲ uː
bhuailfeadh	 vˠ ua l̥ʲ uː
bhuailinn-se	 vˠ ua lʲ i n̻ʲ ʃ e
bhuail	ˈ vˠ ua lʲ
bhuaireamh	 vˠ ua ɾʲ uː
bhuairt	 vˠ ua ɾˠ tʲ
bhualadh	 vˠ ua l̻ˠ uː
bhuartha	ˈ vˠ ua ɾˠ h ə
bhuile	 vˠ i lʲ ə
bhuille	ˈ vˠ i l̻ʲ ə
bhun	ˈ vˠ u n̻ˠ
bí	ˈ bʲ iː
bíodh	ˈ bˠ iː vˠ
bioránach	ˈ bʲ i ɾˠ a n̻ˠ a h
bith	ˈ bʲ iː
bliain	ˈ bʲ lʲ ia nʲ
bliana	ˈ bʲ lʲ ia n̻ˠ ə
blianta	ˈ bʲ lʲ ia n̻ˠ t̪ˠ ə
blúire	ˈ bˠ l̻ˠ uː ɾʲ ə
bó	ˈ bˠ oː
bochta	ˈ bˠ o x t̪ˠ ə
bocht	ˈ bˠ o x t̪ˠ
bodhar	ˈ bˠ au ɾˠ
bóige	ˈ bˠ oː ɟ ə
bóithrín	ˈ bˠ oː hʲ ɾʲ i nʲ
bóithrín	ˈ bˠ oː hʲ ɾʲ i nʲ
bonn	ˈ bˠ o n̻ˠ
bothán	ˈ bˠ o h a n̻ˠ
bóthar	ˈ bˠ oː h ə ɾˠ
bpáirc	 bˠ aː ɾʲ c
bpáircín	 bˠ aː ɾʲ c iː nʲ
bpáirt	 bˠ aː ɾˠ tʲ
bpoll	ˈ bˠ o l̻ˠ
bportach	 bˠ a ɾˠ t̪ˠ a h
bpráta	 bˠ ɾˠ aː t̪ˠ ə
bprísúnach	 bʲ ɾʲ iː ʃ uː n̻ˠ a h
braon	ˈ bˠ ɾˠ iː n̻ˠ
brat	ˈ bˠ ɾˠ a t̪ˠ
breab	ˈ bʲ ɾʲ a bˠ
breac	ˈ bʲ ɾʲ a k
bréagacha	 bʲ ɾʲ eː ɡ a h ə
bréag	ˈ bʲ ɾʲ eː ɡ
breis	ˈ bʲ ɾʲ e ʃ
breith	ˈ bʲ ɾʲ ai hʲ
briogadáin	 bʲ ɾʲ i ɡ ə d̪ˠ a nʲ
briseadh	ˈ bʲ ɾʲ i ʃ uː
briste	ˈ bʲ ɾʲ i ʃ tʲ ə
bróga	 bˠ ɾˠ oː ɡ ə
bróg	ˈ bˠ ɾˠ oː ɡ
bruach	ˈ bˠ ɾˠ ua h
buachaill	ˈ bˠ ua h ə l̻ʲ
buachaillí	 bˠ ua h ə l̻ʲ iː
buadh	 bˠ ua ɣ
buadhdar	 bˠ ua ɣ d̪ˠ ə ɾˠ
buaileadh	ˈ bˠ ua lʲ uː
buile	ˈ bˠ i lʲ ə
buille	ˈ bˠ i l̻ʲ ə
bun	ˈ bˠ u n̻ˠ
bunúsach	ˈ bˠ u n̻ˠ u sˠ a h
cabáiste	ˈ k a bˠ a ʃ tʲ ə
cad	ˈ k a d̪ˠ
cailíní	ˈ k a lʲ i nʲ iː
cailín	ˈ k a lʲ i nʲ
cainte	ˈ k a n̻ʲ tʲ ə
caint	ˈ k a n̻ʲ tʲ
caisleán	ˈ k a ʃ lʲ a n̻ˠ
caitheadh	 k ai ç uː
caitheamh	ˈ k ai hʲ uː
cá	ˈ k aː
caoi	ˈ k iː
caola	 k iː l̻ˠ ə
capall	ˈ k a pˠ ə l̻ˠ
cár	ˈ k aː ɾˠ
casadh	ˈ k a sˠ uː
cás	ˈ k aː sˠ
casúr	ˈ k a sˠ u ɾˠ
cathain	ˈ k a h ə nʲ
cathaoireach	 k a h iː ɾʲ a h
cath	ˈ k a h
cead	ˈ c a d̪ˠ
céad	ˈ c eː d̪ˠ
ceann	ˈ c i n̻ˠ
ceaptí	 c a pʲ tʲ iː
ceart	ˈ c a ɾˠ t̪ˠ
ceathair	ˈ c a h ə ɾʲ
ceathrar	ˈ c a h ɾˠ ə ɾˠ
cé	ˈ c eː
ceist	ˈ c e ʃ tʲ
ceiste	ˈ c e ʃ tʲ ə
chabáiste	 x a bˠ aː ʃ tʲ ə
chaereach	 x eː ɾʲ a h
chailín	ˈ x a lʲ i nʲ
chailleadh	 x a l̻ʲ uː
chaill	ˈ x a l̻ʲ
cháil	ˈ x aː lʲ
chaint	ˈ x a nʲ tʲ
chaisleáin	 x a ʃ lʲ a nʲ
chaisleán	 x a ʃ lʲ a n̻ˠ
chaitheamh	ˈ x a hʲ uː
chaithfeadh	 x ai ç uː
chaithidís	 x ai ç i dʲ iː ʃ
chaithinn	 x ai ç i n̻ʲ
chaith	ˈ x a hʲ
chaoi	ˈ x iː
chapall	 x a pˠ ə l̻ˠ
chasadh	 x a sˠ uː
chathaoir	 x a h iː ɾʲ
cheacht	 ç a ɾˠ t̪ˠ
chéad	ˈ ç eː d̪ˠ
cheannaigh	 ç a n̻ˠ iː
cheann	ˈ ç i n̻ˠ
cheart	ˈ ç a ɾˠ t̪ˠ
cheathrar	 ç a h ɾˠ ə ɾˠ
cheile	 ç e lʲ ə
chéile	ˈ ç e lʲ ə
cheist	ˈ ç e ʃ tʲ
cheithre	ˈ x e ɾʲ ə
chiall	ˈ ç ia l̻ˠ
chiallmhar	 ç ia l̻ˠ vˠ ə ɾˠ
chíosa	 ç iː sˠ ə
chíos	 ç iː sˠ
chirte	 ç i ɾˠ tʲ ə
chíste	 ç iː ʃ tʲ ə
chlampar	 x l̻ˠ a mˠ pˠ ə ɾˠ
chlann	 x l̻ˠ a n̻ˠ
chleamhnas	 ç lʲ au n̻ˠ ə sˠ
chliabháin	 ç lʲ ia vˠ a nʲ
chloch	 x l̻ˠ o h
chlós	 x l̻ˠ oː sˠ
chluas	 x l̻ˠ ua sˠ
chnapóigín	 x n̻ˠ a pˠ oː ɟ iː nʲ
chneasta	 ç nʲ a sˠ t̪ˠ ə
chogadh	 x o ɡ uː
choimeádaidís	 x o mʲ aː d̪ˠ ə dʲ iː ʃ
choimeádfadh	 x o mʲ aː t̪ˠ uː
choimeád	 x o mʲ a d̪ˠ
choínleach	 x iː nʲ lʲ a h
choinne	ˈ x o n̻ʲ ə
choir	 x o ɾʲ
chóir	ˈ x oː ɾʲ
chois	ˈ x o ʃ
cholainn	ˈ x o l̻ˠ ə n̻ʲ
chómnuighe	 x oː mˠ n̻ˠ ə j ə
chomparáid	 x o mˠ pˠ ə ɾˠ a dʲ
chonaic	ˈ x o n̻ˠ ə c
chorcáinín	 x a ɾˠ k aː nʲ iː nʲ
chorp	ˈ x a ɾˠ pˠ
chor	ˈ x a ɾˠ
chosaint	 x a sˠ ə nʲ tʲ
chosain	 x a sˠ ə nʲ
chosa	ˈ x o sˠ ə
chos	 x a sˠ
chreachadh	 ç ɾʲ a h uː
chreach	ˈ ç ɾʲ a h
chreidimh	 ç ɾʲ e dʲ i vʲ
chrích	ˈ ç ɾʲ iː h
chrith	 ç ɾʲ i hʲ
chrochadh	 x ɾˠ o h uː
chroch	ˈ x ɾˠ o h
chrom	 x ɾˠ o mˠ
chró	ˈ x ɾˠ oː
chruinne	 x ɾˠ i n̻ʲ ə
chruinnigh	 x ɾˠ i n̻ʲ iː
chuadar	 x ua d̪ˠ ə ɾˠ
chuaird	 x ua ɾˠ dʲ
chuid	ˈ x i dʲ
chuige	ˈ h i ɟ ə
chúig	ˈ x uː ɟ
chúil	 x uː lʲ
chuimhneamh	 x i vʲ nʲ uː
chúinne	 x uː n̻ʲ ə
chuireadh	ˈ x u ɾʲ uː
chuirfeadh	ˈ x u ɾʲ hʲ uː
chuiridís	 x i ɾʲ i dʲ iː ʃ
chuir	ˈ x u ɾʲ
chúis	ˈ x uː ʃ
chúl	ˈ x uː l̻ˠ
chumas-sa	 x u mˠ ə sˠ sˠ a
chumas	 x u mˠ ə sˠ
chuma	ˈ x u mˠ ə
chun	ˈ x u n̻ˠ
chúrsa	 x uː ɾˠ sˠ ə
chur	ˈ x u ɾˠ
ciall	ˈ c ia l̻ˠ
cine	ˈ c i nʲ ə
cinn	ˈ c i n̻ʲ
cionn	ˈ c i n̻ˠ
ciontach	ˈ c i n̻ˠ t̪ˠ a h
cíosa	 c iː sˠ ə
cíos	ˈ c iː sˠ
ciotóige	 c i t̪ˠ oː ɟ ə
císte	ˈ c iː ʃ tʲ ə
clainne	 k l̻ˠ a n̻ʲ ə
clampair	 k l̻ˠ a mˠ pˠ ə ɾʲ
clampar	ˈ k l̻ˠ a mˠ pˠ ə ɾˠ
clann	ˈ k l̻ˠ a n̻ˠ
cleamhnas	ˈ c lʲ au n̻ˠ ə sˠ
cleas	ˈ c lʲ a sˠ
cleite	ˈ c lʲ e tʲ ə
clocha	ˈ k l̻ˠ a h ə
cloch	ˈ k l̻ˠ a h
cloiche	 k l̻ˠ o hʲ ə
clós	ˈ k l̻ˠ oː sˠ
clúdaithe	 k l̻ˠ uː d̪ˠ iː
cnámha	ˈ k ɾˠ aː vˠ ə
cneasta	ˈ c ɾʲ a sˠ t̪ˠ ə
cnucán	 k n̻ˠ u k a n̻ˠ
cogaidh	ˈ k o ɡ iː
cogarnaigh	 k o ɡ ə ɾˠ n̻ˠ iː
coimeádadh	 k o mʲ aː d̪ˠ uː
coimeádhfaidh	 k o mʲ aː fˠ iː
coínleach	 k iː nʲ lʲ a h
coínlíní	 k iː nʲ lʲ iː nʲ iː
coinneal	ˈ k o n̻ʲ ə l̻ˠ
coise	ˈ k o ʃ ə
cois	ˈ k o ʃ
col	ˈ k o l̻ˠ
cor	ˈ k a ɾˠ
corp	ˈ k o ɾˠ pˠ
cosa	ˈ k o sˠ ə
cos	ˈ k o sˠ
cos-lomrachta	 k a sˠ l̻ˠ o mˠ ɾˠ ə ɾˠ t̪ˠ ə
costais	 k a sˠ t̪ˠ ə ʃ
crainn	 k ɾˠ a n̻ʲ
crann	ˈ k ɾˠ a n̻ˠ
creachadh	ˈ c ɾʲ a x uː
creideamh	ˈ c ɾʲ e dʲ uː
creidimh	ˈ c ɾʲ e dʲ i vʲ
crích	 c ɾʲ iː ç
crochadh	ˈ k ɾˠ o x uː
croise	 k ɾˠ o ʃ ə
cromadh	 k ɾˠ o mˠ uː
cromtha	 k ɾˠ o m̥ˠ ə
crosta	ˈ k ɾˠ i sˠ t̪ˠ ə
cruadh-chíosa	 k ɾˠ ua ɣ ç iː sˠ ə
cruinne	ˈ k ɾˠ i n̻ʲ ə
cruinn	ˈ k ɾˠ i n̻ʲ
cuanta	 k ua n̻ˠ t̪ˠ ə
cuardaigh	ˈ k ua ɾˠ d̪ˠ iː
cúbadh	 k uː bˠ uː
cuid	ˈ k i dʲ
cúigear	ˈ k uː ɟ ə ɾˠ
cúige	ˈ k uː ɟ ə
cúig	ˈ k uː ɟ
cuimhin	ˈ k i vʲ ə nʲ
cuimhneamh	ˈ k i vʲ nʲ uː
cuimhne	ˈ k i vʲ nʲ ə
cúinne	ˈ k uː n̻ʲ ə
cuireadh	ˈ k i ɾʲ uː
cuir	ˈ k i ɾʲ
cúis	ˈ k uː ʃ#x0283;
cuma	ˈ k u mˠ ə
cúpla	ˈ k ə pˠ l̻ˠ ə
cur	ˈ k u ɾˠ
cúrsaí	ˈ k uː ɾˠ sˠ iː
curtha	ˈ k u ɾˠ h ə
dá	ˈ d̪ˠ aː
daingean	ˈ d̪ˠ a ɲ ə n̻ˠ
dána	ˈ d̪ˠ aː n̻ˠ ə
daoibh	ˈ d̪ˠ iː vʲ
daoine	ˈ d̪ˠ iː nʲ iː
daois	 d̪ˠ iː ʃ
daon	 d̪ˠ iː n̻ˠ
daoradh	ˈ d̪ˠ iː ɾˠ uː
darbhar	 d̪ˠ a ɾˠ ə vˠ ə ɾˠ
dár	ˈ d̪ˠ aː ɾˠ
darm	 d̪ˠ a ɾˠ ə mˠ
dathacha	 d̪ˠ a h a h ə
dead	 dʲ a d̪ˠ
déag	ˈ dʲ eː ɡ
deagla	 dʲ i ɡ l̻ˠ ə
dealbh	ˈ dʲ a l̻ˠ ə vˠ
déanamh	ˈ dʲ eː n̻ˠ uː
déanta	ˈ dʲ eː n̻ˠ t̪ˠ ə
déarfadh	 dʲ eː ɾ̥ˠ uː
déarfaidh	ˈ dʲ eː ɾˠ h iː
déarfaidís	 dʲ eː ɾ̥ˠ ə dʲ iː ʃ
de	ˈ d̪ˠ e
dé	ˈ dʲ eː
deich	ˈ dʲ e ç
deighilte	 dʲ eː lʲ tʲ ə
déine	ˈ dʲ eː nʲ ə
deireadh	ˈ dʲ e ɾʲ uː
deiridís	 dʲ e ɾʲ i dʲ iː ʃ
déirigh	ˈ dʲ iː ɾʲ iː
deirim	 dʲ e ɾʲ i mʲ
deirinn	 dʲ e ɾʲ i n̻ʲ
deirtí	 dʲ e ɾˠ tʲ iː
déistineach	ˈ dʲ eː ʃ tʲ ə nʲ a h
déitheach	 dʲ eː ç a h
deoch	ˈ dʲ o h
desganaibh	 dʲ e ʃ ɟ ə n̻ˠ ə vʲ
dfhágfadh	 d̪ˠ aː k uː
dfhan	 d̪ˠ a n̻ˠ
dfhanfainn	 d̪ˠ a n̻̊ˠ ə n̻ʲ
dfhásaidís	 d̪ˠ aː sˠ ə dʲ iː ʃ
dfhéac	 dʲ eː k
dfhéachadar	 dʲ eː h ə d̪ˠ ə ɾˠ
dfhéadadar	 dʲ eː d̪ˠ ə d̪ˠ ə ɾˠ
dfhéadfadh	ˈ d̪ˠ eː d̪ˠ uː
dfhear	 dʲ a ɾˠ
dfhiacalaibh	 dʲ ia k ə l̻ˠ ə vʲ
dhá	ˈ ɣ aː
dhaingean	 ɣ a ɲ ɟ ə n̻ˠ
dhaoine	ˈ ɣ iː nʲ iː
dhaoradh	 ɣ iː ɾˠ uː
dheabhróch	 j oː ɾˠ o h
dheacair	 j a k ə ɾʲ
dheaghshláintíghe	 j ai h l̻ˠ aː nʲ tʲ iː j ə
dhéag	ˈ ɣ eː ɡ
dhéanamh	ˈ j eː n̻ˠ uː
dhéanfadh	ˈ j eː n̻ˠ uː
dhéanfaidh	ˈ ɣ eː n̻ˠ h iː
dheas	ˈ j a sˠ
dhéin	 j eː nʲ
dheirig	 j e ɾʲ i ɟ
dhé	 j eː
dhfhásaid	 ɣ aː sˠ ə dʲ
dhíbirt	 j iː bʲ i ɾˠ tʲ
dhílis	 j iː lʲ i ʃ
dhíobh	 j iː vˠ
dhíoladar	 j iː l̻ˠ ə d̪ˠ ə ɾˠ
dhíoladh	 j iː l̻ˠ uː
dhíolfadh	 j iː l̻̊ˠ uː
dhíol	ˈ j iː l̻ˠ
dhírigh	 j iː ɾʲ iː
dhóbair	 ɣ oː bˠ ə ɾʲ
dhó	 ɣ oː
dhroch	 ɣ ɾˠ o h
dhual	ˈ ɣ ua l̻ˠ
dhubh	ˈ ɣ uː
dhuine	ˈ ɣ i nʲ ə
dhul	 ɣ u l̻ˠ
dian	ˈ dʲ ia n̻ˠ
díbirt	ˈ dʲ iː bʲ ə ɾˠ tʲ
di	ˈ d̪ˠ i
díobháil	ˈ dʲ iː vˠ a lʲ
díobhála	 dʲ iː vˠ aː l̻ˠ ə
díobh	ˈ dʲ iː vˠ
díoladh	 dʲ iː l̻ˠ uː
díol	ˈ dʲ iː l̻ˠ
díreach	ˈ dʲ iː ɾʲ a h
dithe	 dʲ iː
dobair	 d̪ˠ o bˠ ə ɾʲ
dócha	ˈ d̪ˠ oː x ə
do	ˈ d̪ˠ ə
dó	ˈ d̪ˠ oː
dóibh	ˈ d̪ˠ oː vʲ
dóic	 d̪ˠ oː c
dóladh	 d̪ˠ oː l̻ˠ uː
dom	ˈ d̪ˠ uː
domhan	ˈ d̪ˠ au n̻ˠ
donas	ˈ d̪ˠ o n̻ˠ ə sˠ
droch	ˈ d̪ˠ ɾˠ o h
drún	 d̪ˠ ɾˠ uː n̻ˠ
dtabharfadh	ˈ d̪ˠ oː ɾˠ uː
dtabharfaí	 d̪ˠ oː ɾˠ ə fˠ iː
dtabharfainn	 d̪ˠ oː ɾ̥ˠ ə n̻ʲ
dtaca	ˈ d̪ˠ a k ə
dtachtfadh	 d̪ˠ a ɾˠ t̪ˠ uː
dtagadh	 d̪ˠ a ɡ uː
dtalamh	 d̪ˠ a l̻ˠ uː
dtánag-sa	 d̪ˠ aː n̻ˠ ə ɡ sˠ a
dtaobh	ˈ dʲ iː vˠ
dteannta	 dʲ a n̻ˠ t̪ˠ ə
dtí	ˈ dʲ iː
dtigh	ˈ dʲ iː
dtineóntaithe	 dʲ i nʲ oː n̻ˠ t̪ˠ iː
dtiocfadh	ˈ dʲ o k uː
dtráchtfá	 d̪ˠ ɾˠ aː ɾˠ t̪ˠ aː
dtrí	 dʲ ɾʲ iː
dtriúr	 dʲ ɾʲ uː ɾˠ
dtrucail	 d̪ˠ ɾˠ u k ə lʲ
dtugainn	 d̪ˠ u ɡ ə n̻ʲ
dtugtar	 d̪ˠ u ɡ t̪ˠ ə ɾˠ
dtuigfeadh	 d̪ˠ i c uː
dtuigtí	 d̪ˠ i ɟ tʲ iː
duaigneas	 d̪ˠ ua ɟ nʲ ə sˠ
dúbh-chéalacan	 d̪ˠ uː vˠ ç eː l̻ˠ ə k ə n̻ˠ
dubh	ˈ d̪ˠ uː
duibh	ˈ d̪ˠ i vʲ
dúil	ˈ d̪ˠ uː lʲ
duine	ˈ d̪ˠ i nʲ ə
dúinn	ˈ d̪ˠ uː n̻ʲ
duit	ˈ d̪ˠ i tʲ
dul	ˈ d̪ˠ u l̻ˠ
dúnta	ˈ d̪ˠ uː n̻ˠ t̪ˠ ə
éadaigh	ˈ eː d̪ˠ iː
éadain	ˈ eː d̪ˠ ə n̻ʲ
éad	ˈ eː d̪ˠ
eagal	ˈ o ɡ ə l̻ˠ
eagla	ˈ o ɡ l̻ˠ ə
easaontas	ˈ a ˈ sˠ iː n̻ˠ t̪ˠ ə sˠ
é	ˈ eː
éigean	ˈ eː ɟ ə n̻ˠ
éigin	ˈ eː ɟ ə nʲ
éileamh	ˈ eː lʲ uː
eile	ˈ e lʲ ə
éirim	ˈ eː ɾʲ ə mʲ
éis	ˈ eː ʃ
eisean	ˈ e ʃ ə n̻ˠ
éisteacht	ˈ eː ʃ tʲ a x t̪ˠ
fada	ˈ fˠ a d̪ˠ ə
fad	ˈ fˠ a d̪ˠ
fadó	ˈ fˠ a d̪ˠ oː
fágadh	ˈ fˠ aː ɡ uː
fágfar	 fˠ aː ɡ fˠ ə ɾˠ
fágtha	ˈ fˠ aː k ə
fáibrí	 fˠ aː bʲ ɾʲ iː
faid	 fˠ a dʲ
faille	 fˠ a l̻ʲ ə
fáilteach	ˈ fˠ aː l̻ʲ tʲ a h
faire	ˈ fˠ a ɾʲ ə
fairsing	ˈ fˠ a ɾˠ ʃ ə ɲ
fanfaidh	 fˠ a n̻̊ˠ iː
fás	ˈ fˠ aː sˠ
feabhas	ˈ fʲ au sˠ
feaca	 fʲ a k ə
féachaint	ˈ fʲ eː x i nʲ tʲ
féach	ˈ fʲ eː h
féadadh	ˈ fʲ eː d̪ˠ uː
fead	ˈ fʲ a d̪ˠ
feadh	ˈ fʲ au
feall	ˈ fʲ a l̻ˠ
fearaibh	 fʲ a ɾˠ ə vʲ
fear	ˈ fʲ a ɾˠ
féar	ˈ fʲ eː ɾˠ
fearr	ˈ fʲ aː ɾˠ
feiceadh	 fʲ e c uː
féidir	ˈ fʲ eː dʲ ə ɾʲ
féin	ˈ h eː nʲ
feirme	 fʲ e ɾʲ ə mʲ ə
feirm	ˈ fʲ e ɾʲ ə mʲ
feitheamh	ˈ fʲ ai hʲ uː
fhada	ˈ a d̪ˠ ə
fhág	ˈ aː ɡ
fhaid	 a dʲ
fhairsing	 a ɾˠ ʃ i ɲ
fhanadh	 a n̻ˠ uː
fhan	ˈ a n̻ˠ
fhásfaidh	 aː sˠ iː
fheaca	 a k ə
fhéachaint	 eː h ə nʲ tʲ
fhéach	ˈ eː h
fhéadadh	 eː d̪ˠ uː
fhéadaidís	 eː d̪ˠ ə dʲ iː ʃ
fhéadainn	 eː d̪ˠ ə n̻ʲ
fheadar	 a d̪ˠ ə ɾˠ
fhéadfadh	 eː t̪ˠ uː
fhéadfainn	 eː t̪ˠ ə n̻ʲ
fhéad	 eː d̪ˠ
fhear	ˈ a ɾˠ
fhearr	 a ɾˠ
fhéidir	 eː dʲ i ɾʲ
fhéir	ˈ eː ɾʲ
fheirm	 e ɾʲ ə mʲ
fheoil	 oː lʲ
fhios	ˈ i sˠ
fhir	 i ɾʲ
fhiú	 uː
fhocal	ˈ o k ə l̻ˠ
fholáir	 a l̻ˠ a ɾʲ
fhonn	 o n̻ˠ
fhreagair	 ɾʲ i ɡ ə ɾʲ
fhreagairt	 ɾʲ i ɡ ə ɾˠ tʲ
fhreagra	ˈ ɾʲ a ɡ ɾˠ ə
fhuachta	 ua h t̪ˠ ə
fhuacht	ˈ ia x t̪ˠ
fial	ˈ fʲ ia l̻ˠ
fichead	ˈ fʲ i hʲ ə d̪ˠ
fiche	ˈ fʲ i ç ə
fichid	 fʲ i hʲ i dʲ
file	ˈ fʲ i lʲ ə
fill	ˈ fʲ i l̻ʲ
fillte	 fʲ i l̻ʲ tʲ ə
fíor	ˈ fʲ iː ɾˠ
fir	ˈ fʲ i ɾʲ
firín	 fʲ i ɾʲ iː nʲ
fírinne	ˈ fʲ iː ɾʲ ə n̻ʲ ə
fiú	ˈ fʲ uː
fliuch	ˈ fʲ lʲ u h
flúirseach	ˈ fˠ l̻ˠ uː ɾˠ ʃ a h
focail	ˈ fˠ o k ə l̻ˠ
focal	ˈ fˠ o k ə l̻ˠ
foláine	 fˠ a l̻ˠ aː nʲ ə
foláir	ˈ fˠ o ˈ l̻ˠ aː ɾʲ
folamh	ˈ fˠ o l̻ˠ uː
formhór	ˈ fˠ o ɾˠ vˠ o ɾˠ
fós	ˈ fˠ oː sˠ
fraoch	ˈ fˠ ɾˠ iː h
freagairt	 fʲ ɾʲ i ɡ ə ɾˠ tʲ
freagra	ˈ fʲ ɾʲ a ɡ ɾˠ ə
fuaid	 fˠ ua dʲ
fuair	ˈ fˠ ua ɾʲ
fuar	ˈ fˠ ia ɾˠ
fuat	 fˠ ua t̪ˠ
fuath	ˈ fˠ ia
fuinneamh	ˈ fˠ i n̻ʲ uː
fuinnimh	 fˠ i n̻ʲ i vʲ
gabhadh	 ɡ oː ɣ
gabháil	ˈ ɡ o lʲ
gabhair	ˈ ɡ oː ɾʲ
gabhar	ˈ ɡ au ɾˠ
gach	ˈ ɡ a h
gadhar	ˈ ɡ ai ɾˠ
gairbhéal	ˈ ɡ a ɾʲ ə vʲ eː l̻ˠ
gairbhéil	 ɡ a ɾʲ ə vʲ e lʲ
gáire	ˈ ɡ aː ɾʲ ə
gáirí	 ɡ aː ɾʲ iː
gairid	ˈ ɡ a ɾʲ ə dʲ
gais	 ɡ a ʃ
galánta	ˈ ɡ a l̻ˠ a n̻ˠ t̪ˠ ə
galar	 ɡ a l̻ˠ ə ɾˠ
galúinín	 ɡ o l̻ˠ uː nʲ iː nʲ
galún	ˈ ɡ o l̻ˠ u n̻ˠ
gan	ˈ ɡ a n̻ˠ
gandail	 ɡ a n̻ˠ d̪ˠ ə lʲ
gandal	ˈ ɡ a n̻ˠ d̪ˠ ə l̻ˠ
gaol	ˈ ɡ iː l̻ˠ
garaidhthibh	 ɡ a ɾˠ ai hʲ i vʲ
garbh	ˈ ɡ a ɾˠ ə vˠ
garsúinín	 ɡ a ɾˠ sˠ uː nʲ iː nʲ
garsún	ˈ ɡ a ɾˠ sˠ u n̻ˠ
gcaidhséar	 ɡ ai ʃ a ɾˠ
gcailíní	 ɡ a lʲ iː nʲ iː
gcaint	 ɡ a nʲ tʲ
gcaisleán	 ɡ a ʃ lʲ a n̻ˠ
gcaitheamh	ˈ ɡ ai hʲ uː
gcaithfeadh	ˈ ɡ ai hʲ uː
gcara	 ɡ a ɾˠ ə
gcaraigreach	 ɡ a ɾˠ ə ɟ ɾʲ a h
gcasadh	 ɡ a sˠ uː
gcás	 ɡ aː sˠ
gceachtana	 ɟ a ɾˠ t̪ˠ ə n̻ˠ ə
gceacht	 ɟ a ɾˠ t̪ˠ
gcéad	 ɟ eː d̪ˠ
gcéadta	 ɟ eː t̪ˠ ə
gceannas	 ɟ a n̻ˠ ə sˠ
gceann	ˈ ɟ i n̻ˠ
gceart	ˈ ɟ a ɾˠ t̪ˠ
gceist	ˈ ɟ e ʃ tʲ
gcine	 ɟ i nʲ ə
gcionn	ˈ ɟ o n̻ˠ
gcíos	 ɟ iː sˠ
gcirt	 ɟ i ɾˠ tʲ
gclár	 ɡ l̻ˠ aː ɾˠ
gcloch	 ɡ l̻ˠ o h
gcnuicín	 ɡ n̻ˠ i c iː nʲ
gcogaí	 ɡ o ɡ iː
gcóir	 ɡ oː ɾʲ
gcomparáid	 ɡ o mˠ pˠ ə ɾˠ a dʲ
gcorp	ˈ ɡ o ɾˠ pˠ
gcreideamh	 ɟ ɾʲ e dʲ uː
gcrích	 ɟ ɾʲ iː ç
gcrochfaí	 ɡ ɾˠ o h fˠ iː
gcró	ˈ ɡ ɾˠ oː
gcuid	ˈ ɡ i dʲ
gcúig	 ɡ uː ɟ
gcuimhne	 ɡ i vʲ nʲ ə
gcúinne	ˈ ɡ u n̻ʲ ə
gcuirfeadh	ˈ ɡ u ɾʲ hʲ uː
gcúl	 ɡ uː l̻ˠ
gcuma	 ɡ u mˠ ə
geala	ˈ ɟ a l̻ˠ ə
geall	ˈ ɟ a l̻ˠ
gearachaile	 ɟ a ɾˠ ə h ə lʲ ə
géara	 ɟ eː ɾˠ ə
géarchúiseach	ˈ ɟ eː ɾˠ h uː ʃ a h
géar	ˈ ɟ eː ɾˠ
geimhrigh	ˈ ɟ e vʲ ɾʲ iː
géire	ˈ ɟ eː ɾʲ ə
ghabháil	ˈ ɣ o lʲ
ghabhar	 ɣ oː ɾˠ
gháir	ˈ ɣ aː ɾʲ
ghairbéal	 ɣ a ɾʲ ə bʲ a l̻ˠ
ghairbhéal	 ɣ a ɾʲ ə vʲ a l̻ˠ
gháire	ˈ ɣ aː ɾʲ ə
gháirí	 ɣ aː ɾʲ iː
gháiridís	 ɣ aː ɾʲ i dʲ iː ʃ
ghairm	 ɣ a ɾʲ ə mʲ
ghalar	 ɣ a l̻ˠ ə ɾˠ
ghana-chúiseach	 ɣ a n̻ˠ ə h uː ʃ a h
ghandail	 ɣ a n̻ˠ d̪ˠ ə lʲ
gharbh	 ɣ a ɾˠ ə vˠ
gharsúin	 ɣ a ɾˠ sˠ u nʲ
gharsún	 ɣ a ɾˠ sˠ u n̻ˠ
ghas	 ɣ a sˠ
ghealacán	 j a l̻ˠ ə k a n̻ˠ
gheall	ˈ j a l̻ˠ
ghearfadh	 j a ɾ̥ˠ uː
ghé	 j eː
ghiora	 j i ɾˠ ə
ghiorra	 j i ɾˠ ə
ghlacadh	ˈ ɣ l̻ˠ a k uː
ghlacaidís	 ɣ l̻ˠ a k ə dʲ iː ʃ
ghlacfaidís	 ɣ l̻ˠ a k ə dʲ iː ʃ
ghlais	ˈ ɣ l̻ˠ a ʃ
ghlanadh	ˈ ɣ l̻ˠ a n̻ˠ uː
ghlan	ˈ ɣ l̻ˠ a n̻ˠ
ghlór	 ɣ l̻ˠ oː ɾˠ
ghluais	 ɣ l̻ˠ ua ʃ
ghlúin	 ɣ l̻ˠ uː nʲ
ghlún	 ɣ l̻ˠ uː n̻ˠ
ghnímh	 j nʲ iː vʲ
ghníomh	 j nʲ iː vˠ
ghnó	 ɣ n̻ˠ oː
ghnúis	ˈ ɣ ɾˠ uː ʃ
ghoileadar	 ɣ o lʲ ə d̪ˠ ə ɾˠ
ghoile	 ɣ o lʲ ə
ghoill	 ɣ o l̻ʲ
ghráin	 ɣ ɾˠ aː nʲ
ghreim	 j ɾʲ e mʲ
ghualainn	ˈ ɣ ua l̻ˠ ə n̻ʲ
ghustal	 ɣ u sˠ t̪ˠ ə l̻ˠ
glan	ˈ ɡ l̻ˠ a n̻ˠ
glasa	ˈ ɡ l̻ˠ a sˠ ə
glas	ˈ ɡ l̻ˠ a sˠ
gléigeal	ˈ ɟ lʲ eː ɟ ə l̻ˠ
gléineach	ˈ ɟ lʲ eː nʲ a h
glúin	ˈ ɡ l̻ˠ uː nʲ
glún	ˈ ɡ l̻ˠ uː n̻ˠ
gnáth	ˈ ɡ aː
gníomhartha	 ɟ nʲ iː vˠ ə ɾ̥ˠ ə
gníomh	ˈ ɟ ɾʲ iː vˠ
gnó	ˈ ɡ ɾˠ oː
go	ˈ ɡ ə
goile	ˈ ɡ i lʲ ə
gol	 ɡ a l̻ˠ
gorta	ˈ ɡ o ɾˠ t̪ˠ ə
gort	ˈ ɡ o ɾˠ t̪ˠ
gráinne	ˈ ɡ ɾˠ aː n̻ʲ ə
greim	ˈ ɟ ɾʲ i mʲ
gruth	ˈ ɡ ɾˠ u h
gura	ˈ ɡ u ɾˠ ə
gur	ˈ ɡ ə ɾˠ
gustal	ˈ ɡ u sˠ t̪ˠ ə l̻ˠ
h-airightí	 h a ɾʲ iː tʲ iː
h-anspianta	 h a nʲ ʃ pʲ ia n̻ˠ t̪ˠ ə
h-ínnseadh	 h iː n̻ʲ ʃ uː
h-oídhcheanta	 h iː j ç ə n̻ˠ t̪ˠ ə
iad	ˈ ia d̪ˠ
iadsan	 ia d̪ˠ sˠ ə n̻ˠ
iarainn	 ia ɾˠ ə n̻ʲ
iasachta	 ia sˠ ə ɾˠ t̪ˠ ə
idir	ˈ i dʲ ə ɾʲ
i	ˈ i
í	ˈ iː
ime	 i mʲ ə
iniúchadh	ˈ i nʲ u h uː
inti	ˈ i n̻ʲ tʲ iː
iomarca	ˈ i mˠ ə ɾˠ k ə
ionam	ˈ i n̻ˠ ə mˠ
iothlainn	ˈ i h l̻ˠ ə n̻ʲ
íseal	 iː ʃ ə l̻ˠ
is	ˈ i sˠ
isteach	i ʃ ˈ tʲ a h
istigh	i sˠ ˈ t̪ˠ i j
ithe	ˈ i hʲ ə
ith	 i hʲ
labhair	ˈ l̻ˠ oː ɾʲ
labhairt	ˈ l̻ˠ oː ɾʲ tʲ
labhartha	 l̻ˠ oː ɾ̥ˠ ə
lae	ˈ l̻ˠ eː
laethanta	ˈ l̻ˠ eː h ə n̻ˠ t̪ˠ ə
lagachar	ˈ l̻ˠ a ɡ a h ə ɾˠ
lag	ˈ l̻ˠ a ɡ
láidir	ˈ l̻ˠ aː dʲ ə ɾʲ
laige	ˈ l̻ˠ a ɟ ə
láimh	ˈ l̻ˠ aː vʲ
láimhseáil	ˈ l̻ˠ aː vʲ ʃ a lʲ
laistiar	ˈ l̻ˠ a ʃ tʲ ia ɾˠ
laistigh	ˈ l̻ˠ a ʃ tʲ iː
láithreach	ˈ l̻ˠ aː hʲ ɾʲ a h
lá	ˈ l̻ˠ aː
lámhach	ˈ l̻ˠ aː vˠ a h
lámha	ˈ l̻ˠ aː vˠ ə
lámhfad	 l̻ˠ aː vˠ fˠ ə d̪ˠ
lámh	ˈ l̻ˠ aː vˠ
lán	ˈ l̻ˠ aː n̻ˠ
laoghaire	 l̻ˠ iː ə ɾʲ ə
lár	ˈ l̻ˠ aː ɾˠ
lasadh	ˈ l̻ˠ a sˠ uː
lastoir	ˈ l̻ˠ a sˠ t̪ˠ o ɾʲ
lastuaidh	ˈ l̻ˠ a sˠ t̪ˠ ua j
láthair	ˈ l̻ˠ aː h i ɾʲ
leaba	ˈ l̻ʲ a bˠ iː
leabhair	ˈ l̻ʲ oː ɾʲ
leabhar	ˈ l̻ʲ oː ə ɾˠ
leagadh	ˈ l̻ʲ a ɡ uː
leanadar	 lʲ a n̻ˠ ə d̪ˠ ə ɾˠ
leanadh	 lʲ a n̻ˠ uː
leanbh	ˈ l̻ʲ a n̻ˠ ə vˠ
lean	ˈ lʲ a n̻ˠ
léas	ˈ l̻ʲ eː sˠ
leathadh	ˈ l̻ʲ a h uː
leathan	ˈ l̻ʲ a h ə n̻ˠ
leath-bhata	 lʲ a h vˠ a t̪ˠ ə
leath-bhfabhar	 lʲ a h vˠ fˠ oː ɾˠ
leath	ˈ l̻ʲ a h
leat	ˈ lʲ a t̪ˠ
leictheacht	 lʲ e c a ɾˠ t̪ˠ
léi	ˈ lʲ eː
léim	ˈ l̻ʲ eː mʲ
léir	ˈ l̻ʲ eː ɾʲ
leis	ˈ lʲ i ʃ
léis	 lʲ eː ʃ
leithéid	ˈ l̻ʲ eː hʲ i dʲ
leith	ˈ l̻ʲ e hʲ
le	ˈ lʲ e
leo	ˈ lʲ oː
liathróidí	 lʲ ia ɾˠ oː dʲ iː
liathróidín	 lʲ ia ɾˠ oː dʲ iː nʲ
liathróid	ˈ l̻ʲ ia h ɾˠ o dʲ
lín	 lʲ iː nʲ
linn	ˈ lʲ i n̻ʲ
liom	ˈ lʲ o mˠ
líon	ˈ l̻ʲ iː n̻ˠ
líonmhara	 lʲ iː n̻ˠ vˠ ə ɾˠ ə
liúireach	ˈ l̻ʲ uː ɾʲ a h
lobhadh	ˈ l̻ˠ oː vˠ
loch	ˈ l̻ˠ a h
loingeas	ˈ l̻ˠ o ɲ ɟ ə sˠ
loit	ˈ l̻ˠ o tʲ
loma	ˈ l̻ˠ o mˠ ə
lom	 l̻ˠ o mˠ
long	ˈ l̻ˠ o ŋ
lorg	ˈ l̻ˠ a ɾˠ ə ɡ
luath	ˈ l̻ˠ ua
luigh	ˈ l̻ˠ i j
lútáil	ˈ l̻ˠ uː t̪ˠ a lʲ
macántacht	ˈ mˠ a k a n̻ˠ t̪ˠ a x t̪ˠ
macánta	ˈ mˠ a k a n̻ˠ t̪ˠ ə
mac	ˈ mˠ a k
magaidh	 mˠ a ɡ iː
maidin	ˈ mˠ a dʲ i n̻ʲ
maigne	 mˠ a ɟ nʲ ə
maireadh	ˈ mˠ a ɾʲ uː
mairfidh	 mˠ a ɾ̥ʲ iː
maith	ˈ mˠ a hʲ
má	ˈ mˠ a
mám	ˈ mˠ aː mˠ
marbh	ˈ mˠ a ɾˠ ə vˠ
mar	ˈ mˠ a ɾˠ
mathair	ˈ mˠ a h ə ɾʲ
máthair	ˈ mˠ aː h ə ɾʲ
mathar	ˈ mˠ a h ə ɾˠ
mbaile	ˈ mˠ a lʲ ə
mbainfí	 mˠ a nʲ ə fʲ iː
mbainne	 mˠ a n̻ʲ ə
mba	ˈ mˠ ə
mban	ˈ mˠ a n̻ˠ
mbara	 mˠ a ɾˠ ə
mbata	 mˠ a t̪ˠ ə
mbéad	 mʲ eː d̪ˠ
mbeag	 mʲ i ɡ
mbeatha	 mʲ a h ə
mbeidh	ˈ mˠ eː
mbeirt	ˈ mʲ e ɾʲ tʲ
mbínn	 mʲ iː n̻ʲ
mbíodh	ˈ mʲ uː
mbliana	ˈ mʲ lʲ ia n̻ˠ ə
mbocht	 mˠ o ɾˠ t̪ˠ
mbó	 mˠ oː
mbothán	 mˠ a h a n̻ˠ
mbóthar	 mˠ oː h ə ɾˠ
mbraon	 mˠ ɾˠ iː n̻ˠ
meadhg	ˈ mʲ eː ɡ
mealladh	ˈ mʲ o l̻ˠ uː
measaim	 mʲ a sˠ ə mʲ
measa	ˈ mʲ a sˠ ə
meas	ˈ mʲ a sˠ
meathán	ˈ mʲ a h a n̻ˠ
meat	 mʲ a t̪ˠ
méid	ˈ mʲ eː dʲ
mé	ˈ mʲ eː
mhac	ˈ vˠ a k
mhairbh	 vˠ a ɾʲ ə vʲ
mhaireadh	 vˠ a ɾʲ uː
mhair	 vˠ a ɾʲ
mhaise	ˈ vˠ a ʃ ə
mháistiribh	 vˠ aː ʃ tʲ i ɾʲ i vʲ
mhaithe	ˈ vˠ ai hʲ ə
mhaith	ˈ vˠ ai hʲ
mhalairt	 vˠ a l̻ˠ ə ɾˠ tʲ
mháthair	ˈ vˠ aː h ə ɾʲ
mháthar-sa	 vˠ aː h ə ɾˠ sˠ a
mháthar	 vˠ aː h ə ɾˠ
mheabhair	 vʲ oː ɾʲ
mhéar	 vʲ eː ɾˠ
mheas	 vʲ a sˠ
mhéid	ˈ vʲ eː dʲ
mhíle	 vʲ iː lʲ ə
mhinic	ˈ vʲ i nʲ i c
mhion	 vʲ i n̻ˠ
mhí	ˈ vʲ iː
mhná	 vˠ n̻ˠ aː
mhóra	 vˠ oː ɾˠ ə
mhór	ˈ vˠ oː ɾˠ
mhó	ˈ vˠ oː
mhúineadh	ˈ vˠ uː nʲ uː
mhuineál	ˈ vˠ i nʲ a l̻ˠ
mhuintir	ˈ vˠ i tʲ i ɾʲ
mhuin	ˈ vˠ i nʲ
mhullach	ˈ vˠ u l̻ˠ a h
mí-fholáin	 mˠ iː o l̻ˠ a nʲ
míle	ˈ mʲ iː lʲ ə
mílte	 mʲ iː lʲ tʲ ə
mí	ˈ mʲ iː
minic	ˈ mʲ i nʲ i c
miona	 mʲ i n̻ˠ ə
mion	ˈ mʲ i n̻ˠ
mion-uaisle	 mʲ i n̻ˠ ua ʃ lʲ ə
mion-uaislibh	 mʲ i n̻ˠ ua ʃ lʲ i vʲ
mise	ˈ mʲ i ʃ ə
mná	ˈ mˠ ɾˠ aː
mo	ˈ mˠ ə
móra	ˈ mˠ oː ɾˠ ə
mórán	ˈ mˠ oː ɾˠ a n̻ˠ
mór	ˈ mˠ oː ɾˠ
múchta	 mˠ uː ɾˠ t̪ˠ ə
múineadh	ˈ mˠ uː nʲ uː
múinte	ˈ mˠ uː n̻ʲ tʲ ə
múintí	 mˠ uː nʲ tʲ iː
muintir	ˈ mˠ i tʲ i ɾʲ
murabh	 mˠ u ɾˠ oː
murab	ˈ mˠ u ɾˠ ə bˠ
mura	ˈ mˠ u ɾˠ ə
murar	 mˠ u ɾˠ ə ɾˠ
n-aghaidh	 n̻ˠ eː iː
n-aigne	 n̻ˠ a ɟ nʲ ə
náire	ˈ n̻ˠ aː ɾʲ ə
n-ais	 n̻ˠ a sˠ
n-áit	 n̻ˠ aː t̪ˠ
namhad	ˈ n̻ˠ a vˠ ə d̪ˠ
namhaid	ˈ n̻ˠ au dʲ
n-am	ˈ n̻ˠ aː mˠ
ná	ˈ n̻ˠ aː
n-anam	ˈ n̻ˠ a n̻ˠ ə mˠ
na	ˈ n̻ˠ ə
n-aoibhneas	 n̻ˠ iː vʲ nʲ ə sˠ
naoi	ˈ n̻ˠ iː
naomh	ˈ n̻ˠ iː vˠ
n-ár	 n̻ˠ aː ɾˠ
nár	ˈ n̻ˠ aː ɾˠ
n-ar	 n̻ˠ a ɾˠ
ndaoine	ˈ n̻ˠ iː nʲ i
ndéanamh	ˈ nʲ eː n̻ˠ uː
ndéanfadh	ˈ nʲ eː n̻ˠ h uː
ndéanfaí	 nʲ eː n̻ˠ fˠ iː
ndéarfadh	 nʲ eː ɾ̥ˠ uː
ndear	 nʲ a ɾˠ
ndeigheadar	 nʲ eː ə d̪ˠ ə ɾˠ
ndeirtí	 nʲ e ɾˠ tʲ iː
ndiúltuighdís	 nʲ uː l̻ˠ t̪ˠ ə j dʲ iː ʃ
nduine	 n̻ˠ i nʲ ə
neamhamhgarach	 nʲ au vˠ ɡ ə ɾˠ a h
neamhchiontacht	 nʲ au ç i n̻ˠ t̪ˠ a ɾˠ t̪ˠ
neamhshlacht	 nʲ au h l̻ˠ a ɾˠ t̪ˠ
neamhspleadhac	 nʲ au ʃ pʲ lʲ ai ə k
neart	ˈ nʲ a ɾˠ t̪ˠ
ngadhar	 ŋ eː ɾˠ
ngairbhéal	 ŋ a ɾʲ ə vʲ a l̻ˠ
ngandal	 ŋ a n̻ˠ d̪ˠ ə l̻ˠ
ngarsún	 ŋ a ɾˠ sˠ u n̻ˠ
ngéire	 ɲ eː ɾʲ ə
ngnó	 ŋ n̻ˠ oː
ní	ˈ n̻ʲ iː
níor	ˈ n̻ʲ iː ɾˠ
níos	ˈ nʲ iː sˠ
nirt	 nʲ i ɾˠ tʲ
n-ithe	 nʲ iː
nocht	ˈ n̻ˠ o x t̪ˠ
nóin	ˈ n̻ˠ oː nʲ
nó	ˈ n̻ˠ oː
noscail	 n̻ˠ a sˠ k ə lʲ
nuair	ˈ n̻ˠ uː ɾʲ
nua	ˈ n̻ˠ ua
n-uasal	 n̻ˠ ua sˠ ə l̻ˠ
obair	ˈ o bˠ i ɾʲ
ochtar	ˈ a x t̪ˠ ə ɾˠ
ocht	ˈ a x t̪ˠ
ocrais	 o k ɾˠ ə ʃ
ocras	ˈ o k ɾˠ ə sˠ
óga	ˈ oː ɡ ə
óg	ˈ oː ɡ
oibre	ˈ i bʲ ɾʲ ə
oilte	ˈ o l̻ʲ tʲ ə
oiread	ˈ e ɾʲ ə d̪ˠ
olc	ˈ o l̻ˠ k
ollamh	ˈ o l̻ˠ uː
ó	ˈ oː
oraibh	ˈ a ɾˠ ə vʲ
orm	ˈ o ɾˠ ə mˠ
ortha	ˈ o ɾˠ h ə
ort	ˈ o ɾˠ t̪ˠ
os	ˈ o sˠ
páirce	 pˠ aː ɾʲ c ə
páirc	ˈ pˠ aː ɾʲ c
peadar	ˈ pʲ aː d̪ˠ a ɾˠ
pé	ˈ pʲ eː
pháirc	 fˠ aː ɾʲ c
pháirt	 fˠ aː ɾˠ tʲ
pharóiste	 fˠ a ɾˠ oː ʃ tʲ ə
phioc	 fʲ i k
phóca	 fˠ oː k ə
pholl	 fˠ a l̻ˠ
phortaigh	ˈ fˠ a ɾˠ t̪ˠ iː
phort	 fˠ a ɾˠ t̪ˠ
phós	 fˠ oː sˠ
phrátaí	 fˠ ɾˠ aː t̪ˠ iː
phriocfaidís	 fʲ ɾʲ i k ə dʲ iː ʃ
piocadh	ˈ pʲ i k uː
plaoisgeana	 pˠ l̻ˠ iː ʃ ɟ ə n̻ˠ ə
poll	ˈ pˠ o l̻ˠ
pósadh	ˈ pˠ oː sˠ uː
pósta	ˈ pˠ oː sˠ t̪ˠ ə
prátaí	 pˠ ɾˠ aː t̪ˠ iː
práta	ˈ pˠ ɾˠ aː t̪ˠ ə
rabairne	ˈ ɾˠ a bˠ ə ɾˠ nʲ ə
rabhadar	 ɾˠ oː d̪ˠ ə ɾˠ
radharc	ˈ ɾˠ au ɾˠ k
raibh	ˈ ɾˠ oː vˠ
raímhre	 ɾˠ iː vʲ ɾʲ ə
ramhar	ˈ ɾˠ au ɾˠ
rang	ˈ ɾˠ a ŋ
rátha	 ɾˠ aː h ə
reachtaire	ˈ ɾˠ a x t̪ˠ ə ɾʲ ə
réidh	ˈ ɾˠ eː j
riachtanach	ˈ ɾˠ ia x t̪ˠ ə n̻ˠ a h
riamh	ˈ ɾˠ ia vˠ
rian	ˈ ɾˠ ia n̻ˠ
riocht	ˈ ɾˠ i x t̪ˠ
ritheadar	 ɾʲ i hʲ ə d̪ˠ ə ɾˠ
rith	ˈ ɾˠ i hʲ
rithinn	 ɾʲ i hʲ i n̻ʲ
rógaire	ˈ ɾˠ oː ɡ ə ɾʲ ə
rogha	ˈ ɾˠ au
roimhe	ˈ ɾˠ i vʲ ə
roinneadar	 ɾˠ o n̻ʲ ə d̪ˠ ə ɾˠ
ró	ˈ ɾˠ oː
rudaí	ˈ ɾˠ u d̪ˠ iː
rud	ˈ ɾˠ u d̪ˠ
rugadar	 ɾˠ u ɡ ə d̪ˠ ə ɾˠ
rugadh	ˈ ɾˠ u ɡ uː
rug	ˈ ɾˠ u ɡ
sagairt	ˈ sˠ a ɡ ə ɾʲ tʲ
sagart	ˈ sˠ a j ə ɾˠ t̪ˠ
saghas	ˈ sˠ ai sˠ
sámh	ˈ sˠ aː au
san	ˈ sˠ ə n̻ˠ
saor	ˈ sˠ iː ɾˠ
saothar	ˈ sˠ iː h ə ɾˠ
sa	ˈ sˠ ə
sásta	ˈ sˠ aː sˠ t̪ˠ ə
scanradh	ˈ sˠ k aː ɾˠ uː
sciomar	 ʃ c i mˠ ə ɾˠ
scóir	 sˠ k oː ɾʲ
scór	ˈ sˠ k oː ɾˠ
seachas	ˈ ʃ a h ə sˠ
seacht	ˈ ʃ a x t̪ˠ
seál	ˈ ʃ aː l̻ˠ
sealbha	 ʃ a l̻ˠ ə vˠ ə
seana	 ʃ a n̻ˠ ə
sean	ˈ ʃ a n̻ˠ
seanduine	ˈ ʃ a n̻ˠ i nʲ ə
séanfaidís	 ʃ eː n̻̊ˠ ə dʲ iː ʃ
seanfhocail	 ʃ a n̻ˠ ə k ə lʲ
seanfhocal	ˈ ʃ a n̻ˠ o k ə l̻ˠ
seasamh	ˈ ʃ a sˠ uː
sé	ˈ ʃ eː
séideadh	ˈ ʃ eː dʲ uː
seilbh	ˈ ʃ e lʲ ə vʲ
séipéal	ˈ ʃ eː pʲ e l̻ˠ
seisean	ˈ ʃ i ʃ ə n̻ˠ
seo	ˈ ʃ o
shagart	ˈ h a ɡ ə ɾˠ t̪ˠ
shaghas	 h eː sˠ
shamhraidh	 h au ɾˠ iː
shaor	 h iː ɾˠ
sheacht	ˈ h a x t̪ˠ
sheana	 ç a n̻ˠ ə
sheans	 ç a n̻ˠ sˠ
sheasaimh	 ç a sˠ ə vʲ
sheasamh	ˈ hʲ a sˠ uː
shia	 ç ia
shíneadh	 ç iː nʲ uː
shine	 ç i nʲ ə
shínfidís	 ç iː n̥ʲ i dʲ iː ʃ
shin	ˈ h i nʲ
shín	ˈ h iː nʲ
shláinte	 l̻̊ˠ aː nʲ tʲ ə
shliocht	ˈ h lʲ ia x t̪ˠ
shúil	ˈ h uː lʲ
shúl	 h uː l̻ˠ
siad	ˈ ʃ iː d̪ˠ
sia	ˈ ʃ ia
siar	ˈ ʃ ia ɾˠ
sibh	ˈ ʃ i vʲ
sí	ˈ ʃ iː
sínfeadh	 ʃ iː n̥ʲ uː
sínfí	 ʃ iː nʲ fʲ iː
sin	ˈ ʃ i nʲ
sinn	ˈ ʃ i n̻ʲ
sínte	ˈ ʃ iː nʲ tʲ ə
síol	ˈ ʃ iː l̻ˠ
síos	ˈ ʃ iː sˠ
sise	ˈ ʃ i ʃ ə
siúd	ˈ ʃ uː d̪ˠ
slachtmhaire	 sˠ l̻ˠ a ɾˠ t̪ˠ vˠ ə ɾʲ ə
slacht	ˈ sˠ l̻ˠ a x t̪ˠ
sláinte	ˈ sˠ l̻ˠ aː n̻ʲ tʲ ə
slaite	 sˠ l̻ˠ a tʲ ə
slán	ˈ sˠ l̻ˠ aː n̻ˠ
slata	 sˠ l̻ˠ a t̪ˠ ə
sliocht	ˈ ʃ lʲ i ɾˠ t̪ˠ
smúsach	ˈ sˠ mˠ uː sˠ a h
socair	ˈ sˠ o k ə ɾʲ
socarachta	 sˠ o k ə ɾˠ ə ɾˠ t̪ˠ ə
soiléir	ˈ sˠ o lʲ e ɾʲ
soir	ˈ sˠ o ɾʲ
sólás	ˈ sˠ oː l̻ˠ a sˠ
soláthar	ˈ sˠ o l̻ˠ aː h ə ɾˠ
sparaíbh	 sˠ pˠ a ɾˠ iː vʲ
sparaí	 sˠ pˠ a ɾˠ iː
spealadóirí	 sˠ pʲ a l̻ˠ ə d̪ˠ oː ɾʲ iː
spórt	ˈ sˠ pˠ oː ɾˠ t̪ˠ
sruthán	ˈ sˠ ɾˠ uː h aː n̻ˠ
stábla	ˈ sˠ t̪ˠ aː bˠ l̻ˠ ə
stadadar	 sˠ t̪ˠ a d̪ˠ ə d̪ˠ ə ɾˠ
stad	ˈ sˠ t̪ˠ a d̪ˠ
stailc	ˈ sˠ t̪ˠ a lʲ c
staon	ˈ sˠ t̪ˠ iː n̻ˠ
starfhiacal	 sˠ t̪ˠ a ɾʲ ia k ə l̻ˠ
stóca	 sˠ t̪ˠ oː k ə
stoc	ˈ sˠ t̪ˠ o k
stráice	ˈ sˠ t̪ˠ ɾˠ aː c ə
stuama	ˈ sˠ t̪ˠ ua mˠ ə
suaimhneasach	ˈ sˠ ua vʲ nʲ ə sˠ a h
suaimhnis	 sˠ ua vʲ nʲ i ʃ
suas	ˈ sˠ ua sˠ
súil-aibigh	 sˠ uː lʲ a bʲ iː
súile	ˈ sˠ uː lʲ ə
súil	ˈ sˠ uː lʲ
sultmhar	ˈ sˠ u l̻ˠ t̪ˠ vˠ ə ɾˠ
tabhairt	ˈ t̪ˠ oː ɾʲ tʲ
tabhartha	 t̪ˠ oː ɾ̥ˠ ə
t-adhmad	 t̪ˠ eː mˠ ə d̪ˠ
tae	ˈ t̪ˠ eː
tagtí	 t̪ˠ a ɟ tʲ iː
t-aighneas	 t̪ˠ ai nʲ ə sˠ
tailimh-se	 t̪ˠ a lʲ i vʲ ʃ e
tairbhe	ˈ t̪ˠ a ɾʲ ə vʲ ə
t-airgead	 t̪ˠ a ɾʲ ɟ ə d̪ˠ
taitíghe	 t̪ˠ a tʲ iː j ə
talamh	ˈ t̪ˠ o l̻ˠ uː
tamaill	ˈ t̪ˠ a mˠ a l̻ʲ
tamall	ˈ t̪ˠ a mˠ ə l̻ˠ
t-am	ˈ t̪ˠ aː mˠ
t-anam	ˈ t̪ˠ a n̻ˠ ə mˠ
taobh	ˈ t̪ˠ iː vˠ
taoibh	 t̪ˠ iː vʲ
t-aon	ˈ t̪ˠ eː n̻ˠ
t-arán	 t̪ˠ a ɾˠ a n̻ˠ
t-arbhar	 t̪ˠ a ɾˠ vˠ ə ɾˠ
tar	ˈ t̪ˠ a ɾˠ
tá	ˈ t̪ˠ aː
t-athair	ˈ t̪ˠ a h ə ɾʲ
teacht	ˈ tʲ a x t̪ˠ
téagar	ˈ tʲ eː ɡ ə ɾˠ
teanga	ˈ tʲ a ŋ ə
teas	ˈ tʲ a sˠ
teip	ˈ tʲ e pʲ
t-éitheach	 tʲ eː ç a h
teitheadh	ˈ tʲ ai hʲ uː
teith	ˈ tʲ ai hʲ
thabhairt	ˈ h oː ɾʲ tʲ
thabharfadh	 h oː ɾ̥ˠ uː
thagadh	ˈ h a ɡ a h
thagaidís	 h a ɡ ə dʲ iː ʃ
thagainn	 h a ɡ ə n̻ʲ
tháinig	ˈ h aː nʲ ə ɟ
thairis	ˈ h a ɾʲ ə ʃ
thalamh	ˈ h a l̻ˠ uː
thall	ˈ h a l̻ˠ
thaobh	ˈ h iː vˠ
thar	ˈ h a ɾˠ
theacht	ˈ hʲ a x t̪ˠ
theannta	 hʲ a n̻ˠ t̪ˠ ə
theas	ˈ hʲ a sˠ
the	 hʲ e
théighmís	 hʲ eː j mʲ iː ʃ
theip	 hʲ e pʲ
theitheadar	 hʲ ai ç ə d̪ˠ ə ɾˠ
thiar	ˈ hʲ ia ɾˠ
thigh	 hʲ iː
thímpal-sa	 hʲ iː mʲ pʲ ə l̻ˠ sˠ a
thiocfadh	ˈ hʲ i k a h
thíos	ˈ hʲ iː sˠ
thógadh	 h oː ɡ uː
thógfadh	 h oː k uː
thóg	ˈ h oː ɡ
thoir	ˈ h o ɾʲ
thoradh	 h a ɾˠ uː
thosach	 h a sˠ a h
threise	 ɾ̥ʲ e ʃ ə
thriail	 ɾ̥ʲ ia lʲ
thrí	ˈ hʲ ɾʲ iː
thuaidh	ˈ h ua j
thuas	ˈ h ua sˠ
thugadar	 h u ɡ ə d̪ˠ ə ɾˠ
thugadh	 h u ɡ uː
thugainn	 h u ɡ ə n̻ʲ
thug	ˈ h u ɡ
thuiginn	 h i ɟ i n̻ʲ
tigh	ˈ t̪ˠ iː
tír	ˈ tʲ iː ɾʲ
t-ocras	 t̪ˠ o k ɾˠ ə sˠ
tógadh	ˈ t̪ˠ oː ɡ uː
tógtha	ˈ t̪ˠ oː k ə
tógtí	 t̪ˠ oː ɟ tʲ iː
toil	ˈ t̪ˠ o lʲ
tón-leathan	 t̪ˠ oː n̻ˠ lʲ a h ə n̻ˠ
toradh	ˈ t̪ˠ a ɾˠ uː
tráchtadh	 t̪ˠ ɾˠ aː ɾˠ t̪ˠ uː
trácht	ˈ t̪ˠ ɾˠ aː x t̪ˠ
tráthnóna	t̪ˠ ɾˠ a ˈ n̻ˠ oː n̻ˠ ə
tráth	ˈ t̪ˠ ɾˠ aː
treabhchas	ˈ tʲ ɾʲ oː h ə sˠ
treana	 tʲ ɾʲ a n̻ˠ ə
treise	ˈ tʲ ɾʲ e ʃ ə
tréithe	 tʲ ɾʲ eː ç ə
triall	ˈ tʲ ɾʲ ia l̻ˠ
tríd	ˈ tʲ ɾʲ iː dʲ
trioblóide	 tʲ ɾʲ i bˠ l̻ˠ oː dʲ ə
tríochad	 tʲ ɾʲ ia h ə d̪ˠ
tríthi	ˈ tʲ ɾʲ iː hʲ iː
trí	ˈ tʲ ɾʲ iː
triúr	ˈ tʲ ɾʲ uː ɾˠ
troid	ˈ t̪ˠ ɾˠ o dʲ
trom	ˈ t̪ˠ ɾˠ o mˠ
trucail	ˈ t̪ˠ ɾˠ u k ə lʲ
tsamhraidh	ˈ t̪ˠ au ɾˠ iː
tseift	 tʲ e fʲ tʲ
tséipéil	 tʲ eː pʲ e lʲ
tsráid	 t̪ˠ ɾˠ aː dʲ
tuairim	ˈ t̪ˠ ua ɾʲ i mʲ
t-ualach	 t̪ˠ ua l̻ˠ a h
tugadh	ˈ t̪ˠ u ɡ a h
tugtar	 t̪ˠ u ɡ t̪ˠ ə ɾˠ
tuigeadh	 t̪ˠ i ɟ uː
tuirse	ˈ t̪ˠ i ɾˠ ʃ ə
t-urchar	 t̪ˠ u ɾˠ h ə ɾˠ
tur	ˈ t̪ˠ u ɾˠ
tusa	ˈ t̪ˠ u sˠ ə
tú	ˈ t̪ˠ uː
uachtarach	ˈ ua x t̪ˠ ə ɾˠ a h
uaibh	ˈ ua vʲ
uaidh	ˈ ua j
uaigneacha	 ua ɟ nʲ a h ə
uaim	ˈ ua mʲ
uainn	ˈ ua n̻ʲ
uain	ˈ ua nʲ
uaireanta	 ua ɾʲ ə n̻ˠ t̪ˠ ə
uair	ˈ ua ɾʲ
uaisle	ˈ ua ʃ lʲ ə
uait	ˈ ua tʲ
ualache	 ua l̻ˠ ə ç ə
ualach	ˈ ua l̻ˠ a h
uasal	ˈ ua sˠ ə l̻ˠ
uatha	ˈ ua h ə
úd	ˈ uː d̪ˠ
uí	ˈ iː
uile	ˈ i lʲ ə
uirthi	ˈ a ɾˠ hʲ iː
umam	ˈ u mˠ ə mˠ
um	ˈ u mˠ
urchair	 u ɾˠ ə x ə ɾʲ
urchar	ˈ u ɾˠ a h ə ɾˠ
urlabhra	ˈ u ɾˠ l̻ˠ oː ɾˠ ə
úsáid	ˈ uː sˠ a dʲ
á	aː
aduaidh	ə ˈ d̪ˠ ua j
aeraíocht	ˈ eː ɾˠ iː a x t̪ˠ
agaibhse	 a ɡ ə vʲ ʃ ə
agamsa	ˈ ə ɡ ə mˠ sˠ ə
aicisí	 a c i ʃ iː
aigesean	 a ɟ ə ʃ ə n̻ˠ
ainm	ˈ a nʲ ə mʲ
airde	ˈ aː ɾʲ dʲ ə
airde(	 a ɾˠ dʲ ə
airíodar	 a ɾʲ iː d̪ˠ ə ɾˠ
amas	ˈ a mˠ ə sˠ
amuigh	ə ˈ mˠ i j
aniar	ə ˈ n̻ʲ ia ɾˠ
arís	ə ˈ ɾʲ iː ʃ
astu	ˈ a sˠ t̪ˠ uː
aturnae	ˈ a t̪ˠ u ɾˠ n̻ˠ eː
bailithe	 bˠ a lʲ iː
baol	ˈ bˠ iː l̻ˠ
barr	ˈ bˠ aː ɾˠ
beithíoch	ˈ bʲ ai hʲ iː a h
bhaol	 vˠ iː l̻ˠ
bharr	ˈ vˠ aː ɾˠ
bhreá	ˈ vʲ ɾʲ aː
bhreoiteacht	 vʲ ɾʲ oː tʲ a ɾˠ t̪ˠ
bhreoiteachtaí	 vʲ ɾʲ oː tʲ ə ɾˠ t̪ˠ iː
bhrí	 vʲ ɾʲ iː
bhrú	 vˠ ɾˠ uː
bhuí	ˈ vˠ iː
bithiúnach	ˈ bʲ i hʲ u n̻ˠ a h
bosca	ˈ bˠ o k sˠ ə
bpoiblíocht	 bˠ o bʲ lʲ ia ɾˠ t̪ˠ
bponc	ˈ bˠ o ŋ k
breá	ˈ bʲ ɾʲ aː
breátha	 bʲ ɾʲ aː h ə
breathnú	 bʲ ɾʲ a h n̻ˠ uː
breoiteacht	ˈ bʲ ɾʲ oː tʲ a x t̪ˠ
brí	ˈ bʲ ɾʲ iː
bríomhar	ˈ bʲ ɾʲ iː vˠ ə ɾˠ
brú	ˈ bˠ ɾˠ uː
charraig	ˈ x a ɾˠ ə ɟ
chlaí	ˈ x l̻ˠ iː
chnoc	 x n̻ˠ o k
chnoic	 x n̻ˠ o c
choláiste	 x a l̻ˠ aː ʃ tʲ ə
chosc	 x a sˠ k
claí	ˈ k l̻ˠ iː
cleasaíocht	ˈ c lʲ a sˠ iː a x t̪ˠ
codladh	ˈ k o l̻ˠ uː
coigríoch	ˈ k o ɟ ɾʲ i h
coláiste	ˈ k o l̻ˠ aː ʃ tʲ ə
comhluadar	ˈ k oː l̻ˠ ua d̪ˠ ə ɾˠ
cónaí	ˈ k oː n̻ˠ iː
críostaí	ˈ c ɾʲ iː sˠ t̪ˠ iː
daireofá	 d̪ˠ a ɾʲ oː h aː
dár	ˈ d̪ˠ aː ɾˠ
dardaigh	 d̪ˠ a ɾˠ d̪ˠ iː
déileamh	 dʲ eː lʲ uː
deimhneach	ˈ dʲ e vʲ nʲ a h
deirimse	 dʲ e ɾʲ i mʲ ʃ ə
déiríodar	 dʲ eː ɾʲ iː d̪ˠ ə ɾˠ
deisbhéalaí	 dʲ e ʃ vʲ eː l̻ˠ iː
den	ˈ dʲ ə nʲ
deo	ˈ dʲ oː
dfháil	 d̪ˠ aː lʲ
dfhéach	ˈ dʲ eː h
dhéanfaimid	ˈ ɣ eː n̻ˠ ə mˠ i dʲ
dhearbhaigh	 j a ɾˠ ə vˠ iː
dhísciú	 j iː ʃ c uː
difríocht	ˈ dʲ i fʲ ɾʲ iː a x t̪ˠ
dimigh	ˈ dʲ i mʲ iː
dinis	ˈ dʲ i nʲ ə ʃ
diompaigh	 dʲ i mˠ pˠ iː
diompaíodar	 dʲ i mˠ pˠ ia d̪ˠ ə ɾˠ
dlí	ˈ dʲ lʲ iː
dlíthe	 dʲ lʲ iː hʲ ə
don	ˈ d̪ˠ o n̻ˠ
dronnaí	 d̪ˠ ɾˠ o n̻ˠ iː
dtreo	ˈ dʲ ɾʲ oː
dúirt	ˈ d̪ˠ uː ɾʲ tʲ
ea	ˈ a
éagóir	ˈ eː ɡ o ɾʲ
éagóra	 eː ɡ oː ɾˠ ə
éalú	ˈ eː l̻ˠ uː
eoghan	 oː ə n̻ˠ
eolas	ˈ oː l̻ˠ ə sˠ
fé	 fʲ eː
feiscint	 fʲ e ʃ c i nʲ tʲ
fraincis	 fˠ ɾˠ a ɲ c i ʃ
fraincise	 fˠ ɾˠ a ɲ c i ʃ ə
gaeil	ˈ ɡ eː lʲ
gael	ˈ ɡ eː l̻ˠ
gaelacha	 ɡ eː l̻ˠ a h ə
gairdín	ˈ ɡ aː ɾˠ dʲ i nʲ
garraí	ˈ ɡ a ɾˠ iː
garraithe	 ɡ a ɾˠ iː
gasra	ˈ ɡ a sˠ ɾˠ ə
gcaitear	 ɡ a tʲ ə ɾˠ
gcarraig	 ɡ a ɾˠ ə ɟ
gcnoc	 ɡ n̻ˠ o k
gcoláiste	 ɡ a l̻ˠ aː ʃ tʲ ə
gcomhaireamh	 ɡ oː ɾʲ uː
gcónaí	ˈ ɡ oː n̻ˠ iː
gharraí	ˈ ɣ a ɾˠ iː
ghrámhar	 ɣ ɾˠ aː vˠ ə ɾˠ
ghránna	 ɣ ɾˠ aː n̻ˠ ə
ghunna	 ɣ u n̻ˠ ə
glaoch	ˈ ɡ l̻ˠ iː h
glaoite	 ɡ l̻ˠ iː tʲ ə
gurbh	 ɡ u ɾˠ ə vˠ
háit	 h aː tʲ
háite	 h aː tʲ ə
hálainn	 h aː l̻ˠ ə n̻ʲ
hamháin	 h au a nʲ
hana	 h a n̻ˠ ə
hanam	ˈ h a n̻ˠ ə mˠ
haon	ˈ h e n̻ˠ
hardaíodh	 h a ɾˠ d̪ˠ iː uː
hathair	 h a h ə ɾʲ
hathar	 h a h ə ɾˠ
hathbhliana	 h a hʲ vʲ lʲ ia n̻ˠ ə
hea	ˈ h a
héagóra	 hʲ eː ɡ oː ɾˠ ə
héagruas	 hʲ eː ɡ ɾˠ ua sˠ
héilíodh	 hʲ eː lʲ iː uː
héireann	ˈ h eː ɾʲ ə n̻ˠ
héirinn	 hʲ eː ɾʲ i n̻ʲ
héitheach	 hʲ eː ç a h
hicí	 hʲ i c iː
hoíche	ˈ h iː hʲ ə
holc	 h a l̻ˠ k
huacht	 h ua h t̪ˠ
huafás	 h ua fˠ a sˠ
huair	 h ua ɾʲ
huaire	ˈ h ua ɾʲ ə
huaisle	 h ua ʃ lʲ ə
hullamh	 h u l̻ˠ uː
iarracht	ˈ ia ɾˠ a x t̪ˠ
iarraidh	ˈ ia ɾˠ iː
icí	 i c iː
im	ˈ i mʲ
imeacht	ˈ i mʲ a x t̪ˠ
imigéiniúla	 i mʲ i ɟ eː nʲ uː l̻ˠ ə
in	ˈ i nʲ
léirscrios	ˈ l̻ʲ eː ɾʲ ʃ c ɾʲ i sˠ
leithscéal	ˈ l̻ʲ e ʃ c e l̻ˠ
leithscéil	 lʲ ai ç ʃ c e lʲ
liú	ˈ l̻ʲ uː
lóistín	ˈ l̻ˠ oː ʃ tʲ i nʲ
lú	ˈ l̻ˠ uː
lúnasa	ˈ l̻ˠ uː n̻ˠ ə sˠ ə
maíomh	ˈ mˠ iː vˠ
maireann	 mˠ a ɾʲ ə n̻ˠ
máistir	ˈ mˠ aː ʃ tʲ ə ɾʲ
maraíodh	 mˠ a ɾˠ iː uː
marcaíocht	ˈ mˠ a ɾˠ k iː a x t̪ˠ
marú	ˈ mˠ a ɾˠ uː
más	ˈ mˠ aː sˠ
mathairse	 mˠ a h ə ɾˠ ʃ ə
mbáfaí	 mˠ aː fˠ iː
mbord	 mˠ oː ɾˠ d̪ˠ
mbrí	 mʲ ɾʲ iː
mbuí	 mˠ iː
mearaí	ˈ mʲ a ɾˠ iː
measc	ˈ mʲ a sˠ k
meascán	ˈ mʲ a sˠ k a n̻ˠ
meathlú	 mʲ a h l̻ˠ uː
mhaidin	ˈ vˠ a dʲ i n̻ʲ
mháistir	ˈ vˠ aː ʃ tʲ i ɾʲ
mhiste	ˈ vʲ i ʃ tʲ ə
nach	ˈ n̻ˠ a h
n-achrann	 n̻ˠ a h ɾˠ ə n̻ˠ
naifric	 n̻ˠ a fʲ ɾʲ i c
neamhscáfar	 nʲ au sˠ k aː fˠ ə ɾˠ
ngael	ˈ ŋ eː l̻ˠ
ngaisce	 ŋ a ʃ c ə
ngarraí	 ŋ a ɾˠ iː
ngiorracht	 ɲ i ɾˠ a ɾˠ t̪ˠ
ón	ˈ oː n̻ˠ
ord	ˈ oː ɾˠ d̪ˠ
ormsa	ˈ o ɾˠ ə mˠ sˠ ə
oscail	ˈ o sˠ k ə lʲ
oscailt	ˈ o sˠ k ə l̻ʲ tʲ
phléascamar	 fʲ lʲ eː sˠ k ə mˠ ə ɾˠ
ré	ˈ ɾˠ eː
saibhir	ˈ sˠ e vʲ ə ɾʲ
saibhreas	ˈ sˠ e vʲ ɾʲ ə sˠ
sailí	 sˠ a lʲ iː
sáite	ˈ sˠ aː tʲ ə
scafaire	ˈ sˠ k a fˠ ə ɾʲ ə
scaoil	ˈ sˠ k iː lʲ
scaoileadh	ˈ sˠ k iː lʲ uː
scar	ˈ sˠ k a ɾˠ
scaradh	ˈ sˠ k a ɾˠ uː
scáth	 sˠ k aː h
scéal	ˈ ʃ c eː l̻ˠ
scéalta	 ʃ c eː l̻ˠ t̪ˠ ə
sceiche	 ʃ c e hʲ ə
scéil	ˈ ʃ c eː lʲ
sceithe	 ʃ c ai ç ə
sceon	 ʃ c oː n̻ˠ
scian	ˈ ʃ c ia n̻ˠ
sciathóige	 ʃ c ia oː ɟ ə
sciúradh	ˈ ʃ c uː ɾˠ uː
sclábhaíochta	 sˠ k l̻ˠ aː vˠ ia h t̪ˠ ə
scoil	ˈ sˠ k o lʲ
scoile	ˈ sˠ k o lʲ ə
scoileanna	 sˠ k o lʲ ə n̻ˠ ə
scoiltfeadh	 sˠ k o lʲ tʲ uː
aice	ˈ a c ə
cárbh	 k aː ɾˠ vˠ
cérbh	 c eː ɾʲ vʲ
dárbh	 d̪ˠ aː ɾˠ vˠ
dhea	 j a
éirinn	ˈ eː ɾʲ ə n̻ʲ
gurb	ˈ ɡ a ɾˠ ə bˠ
lena	ˈ lʲ e n̻ˠ ə
mbfhéidir	 mʲ eː dʲ i ɾʲ
nárbh	ˈ n̻ˠ a ɾˠ ə vˠ
níorbh	ˈ n̻ʲ iː ɾˠ ə vˠ
