lʲ	lʲ
l̻̊ˠ	lˠ
l̻̊ʲ	lʲ
l̻ˠ	lˠ
l̥ʲ	lʲ
l̻ʲ	lʲ
l̥ˠ	lˠ
lˠ	lˠ
m̥ˠ	mˠ
n̥ʲ	nʲ
nʲ	nʲ
n̻̊ˠ	nˠ
n̻ʲ	nʲ
n̻ˠ	nˠ
n̥ˠ	nˠ
nˠ	nˠ
ɾ̥ˠ	ɾˠ
ɾ̥ʲ	ɾʲ
ɾʲ	ɾʲ
ɾˠ	ɾˠ
